//MAP CONVERTED BY dmm2tgm.py THIS HEADER COMMENT PREVENTS RECONVERSION, DO NOT REMOVE
"ah" = (
/obj/item/flashlight/flare/torch/metal,
/turf/open/floor/rogue/naturalstone,
/area/rogue)
"az" = (
/obj/structure/closet/dirthole/closed,
/mob/living/carbon/human/species/skeleton/npc/ambush,
/obj/effect/spawner/roguemap/loot/rare,
/turf/open/floor/rogue/dirt,
/area/rogue)
"aG" = (
/obj/item/natural/rock,
/turf/open/floor/rogue/naturalstone,
/area/rogue)
"aH" = (
/turf/open/floor/rogue/naturalstone,
/area/rogue)
"aX" = (
/turf/open/transparent/openspace,
/area/rogue)
"bd" = (
/obj/structure/chair/stool/rogue,
/turf/open/floor/rogue/naturalstone,
/area/rogue)
"cc" = (
/obj/structure/closet/dirthole/grave,
/obj/item/rogueweapon/shovel,
/turf/open/floor/rogue/dirt/road,
/area/rogue)
"dr" = (
/obj/item/natural/stone,
/turf/open/floor/rogue/naturalstone,
/area/rogue)
"dE" = (
/obj/structure/closet/dirthole/closed,
/obj/effect/spawner/roguemap/loot/weapon,
/turf/open/floor/rogue/dirt,
/area/rogue)
"ew" = (
/obj/structure/closet/dirthole/closed,
/obj/item/clothing/neck/roguetown/gorget/copper,
/obj/item/clothing/head/roguetown/helmet/coppercap,
/mob/living/carbon/human/species/skeleton/npc/ambush,
/mob/living/carbon/human/species/skeleton/npc/ambush,
/turf/open/floor/rogue/dirt,
/area/rogue)
"eK" = (
/obj/item/natural/stone{
	pixel_x = 2;
	pixel_y = -8
	},
/turf/open/floor/rogue/naturalstone,
/area/rogue)
"eL" = (
/obj/structure/stairs/stone,
/turf/open/floor/rogue/dirt/road,
/area/rogue)
"fy" = (
/obj/structure/closet/dirthole,
/turf/open/floor/rogue/dirt/road,
/area/rogue)
"gp" = (
/obj/item/rogueweapon/shovel,
/turf/open/floor/rogue/dirt,
/area/rogue)
"gT" = (
/obj/item/natural/rock/gold,
/turf/open/floor/rogue/naturalstone,
/area/rogue)
"hQ" = (
/obj/structure/flora/roguegrass/bush_meagre,
/turf/open/floor/rogue/grass/yel,
/area/rogue)
"hY" = (
/obj/structure/closet/dirthole/closed,
/obj/effect/spawner/roguemap/loot/armor,
/mob/living/carbon/human/species/skeleton/npc/ambush,
/turf/open/floor/rogue/dirt/road,
/area/rogue)
"in" = (
/turf/open/floor/rogue/dirt,
/area/rogue)
"iv" = (
/obj/structure/closet/dirthole/grave,
/obj/structure/closet/crate/coffin,
/obj/item/organ/guts,
/obj/item/organ/lungs,
/obj/item/organ/heart,
/obj/item/organ/tongue,
/obj/item/organ/brain,
/turf/open/floor/rogue/dirt,
/area/rogue)
"iL" = (
/obj/structure/closet/dirthole/closed,
/obj/item/rogueweapon/shield/tower/buckleriron,
/turf/open/floor/rogue/dirt,
/area/rogue)
"iR" = (
/turf/closed/mineral/rogue/bedrock,
/area/rogue)
"lA" = (
/obj/structure/closet/dirthole/grave,
/turf/open/floor/rogue/dirt,
/area/rogue)
"mj" = (
/obj/structure/closet/dirthole/closed,
/obj/effect/spawner/roguemap/loot/common,
/turf/open/floor/rogue/dirt,
/area/rogue)
"mu" = (
/obj/structure/roguerock{
	icon_state = "rock2"
	},
/turf/open/floor/rogue/naturalstone,
/area/rogue)
"mJ" = (
/obj/structure/flora/roguegrass/herb/atropa,
/turf/open/floor/rogue/grass/yel,
/area/rogue)
"mN" = (
/obj/item/natural/stone{
	pixel_x = 9;
	pixel_y = 5
	},
/turf/open/floor/rogue/naturalstone,
/area/rogue)
"oB" = (
/obj/structure/stairs/stone{
	dir = 1
	},
/turf/open/floor/rogue/herringbone,
/area/rogue)
"oM" = (
/obj/structure/closet/dirthole/grave,
/obj/structure/closet/crate/coffin,
/mob/living/carbon/human/species/skeleton/npc/warrior/skilled,
/mob/living/carbon/human/species/skeleton/npc/warrior/skilled,
/obj/effect/spawner/roguemap/loot/rare,
/obj/effect/spawner/roguemap/loot/coin/med,
/turf/open/floor/rogue/dirt,
/area/rogue)
"pr" = (
/turf/open/floor/rogue/herringbone,
/area/rogue)
"qA" = (
/obj/structure/fluff/clodpile,
/turf/open/floor/rogue/dirt,
/area/rogue)
"rp" = (
/turf/closed/wall/mineral/rogue/decostone/end{
	dir = 8
	},
/area/rogue)
"rr" = (
/obj/structure/closet/dirthole/closed,
/obj/item/clothing/suit/roguetown/armor/cuirass/copperchest,
/turf/open/floor/rogue/dirt,
/area/rogue)
"rU" = (
/obj/structure/closet/dirthole/closed,
/mob/living/carbon/human/species/skeleton/npc/peasant,
/obj/item/rogueweapon/shield/tower,
/obj/item/rogueweapon/mace/copperbludgeon,
/turf/open/floor/rogue/dirt,
/area/rogue)
"si" = (
/obj/structure/flora/ausbushes/reedbush,
/turf/open/water/swamp,
/area/rogue)
"sF" = (
/obj/structure/closet/dirthole/closed,
/obj/item/rogueweapon/mace/spiked,
/turf/open/floor/rogue/dirt,
/area/rogue)
"tc" = (
/turf/closed/wall/mineral/rogue/decostone/end{
	dir = 4
	},
/area/rogue)
"tW" = (
/obj/item/natural/stone{
	pixel_x = -3;
	pixel_y = 5
	},
/turf/open/floor/rogue/naturalstone,
/area/rogue)
"vd" = (
/obj/structure/roguerock{
	icon_state = "rock3"
	},
/turf/open/floor/rogue/naturalstone,
/area/rogue)
"vl" = (
/obj/structure/kneestingers,
/turf/open/water/swamp,
/area/rogue)
"wj" = (
/obj/structure/kneestingers{
	icon_state = "glowshroom2"
	},
/turf/open/water/swamp,
/area/rogue)
"wu" = (
/obj/structure/closet/dirthole/closed,
/mob/living/carbon/human/species/skeleton/npc/ambush,
/turf/open/floor/rogue/dirt,
/area/rogue)
"xc" = (
/obj/structure/roguerock{
	icon_state = "rock4"
	},
/turf/open/floor/rogue/naturalstone,
/area/rogue)
"xy" = (
/obj/structure/closet/dirthole/closed,
/obj/effect/spawner/roguemap/loot/common,
/mob/living/carbon/human/species/skeleton/npc/warrior,
/turf/open/floor/rogue/dirt/road,
/area/rogue)
"xP" = (
/obj/structure/gravemarker,
/obj/structure/closet/dirthole/closed/loot,
/turf/open/floor/rogue/dirt,
/area/rogue)
"yG" = (
/obj/structure/closet/dirthole/closed,
/mob/living/carbon/human/species/skeleton/npc/warrior/skilled,
/obj/effect/spawner/roguemap/loot/armor,
/obj/effect/spawner/roguemap/loot/coin/low,
/turf/open/floor/rogue/dirt,
/area/rogue)
"zU" = (
/obj/item/natural/stone{
	pixel_x = -6;
	pixel_y = -7
	},
/obj/item/natural/stone{
	pixel_x = 9;
	pixel_y = 5
	},
/turf/open/floor/rogue/naturalstone,
/area/rogue)
"AG" = (
/obj/structure/gravemarker,
/obj/structure/closet/dirthole/closed/loot,
/turf/open/floor/rogue/dirt/road,
/area/rogue)
"AQ" = (
/obj/item/restraints/legcuffs/beartrap/armed/camouflage,
/turf/open/floor/rogue/naturalstone,
/area/rogue)
"Bh" = (
/obj/structure/kneestingers{
	icon_state = "glowshroom_A3"
	},
/turf/open/floor/rogue/dirt,
/area/rogue)
"BF" = (
/obj/structure/closet/dirthole/closed,
/mob/living/carbon/human/species/skeleton/no_equipment,
/turf/open/floor/rogue/dirt,
/area/rogue)
"Cj" = (
/obj/item/ingot/gold,
/obj/item/ingot/gold{
	pixel_x = 8;
	pixel_y = -4
	},
/obj/item/ingot/gold{
	pixel_x = 4;
	pixel_y = 3
	},
/turf/open/water/swamp/deep,
/area/rogue)
"CI" = (
/obj/structure/kneestingers,
/turf/open/floor/rogue/dirt,
/area/rogue)
"CZ" = (
/obj/structure/closet/dirthole/closed,
/turf/open/floor/rogue/dirt,
/area/rogue)
"Dz" = (
/obj/item/natural/dirtclod,
/obj/item/reagent_containers/food/snacks/produce/poppy{
	pixel_x = 9
	},
/obj/item/clothing/head/peaceflower{
	pixel_y = -10;
	pixel_x = -8
	},
/turf/open/floor/rogue/dirt,
/area/rogue)
"DA" = (
/obj/structure/closet/dirthole/grave,
/obj/structure/closet/burial_shroud,
/obj/effect/spawner/roguemap/loot/weapon,
/mob/living/carbon/human/species/skeleton/npc/ambush,
/turf/open/floor/rogue/dirt/road,
/area/rogue)
"DH" = (
/obj/item/natural/stone{
	pixel_x = 6;
	pixel_y = -5
	},
/obj/item/natural/stone{
	pixel_x = -3;
	pixel_y = 7
	},
/turf/open/floor/rogue/naturalstone,
/area/rogue)
"Ei" = (
/obj/item/kitchen/spoon/iron{
	pixel_y = 3;
	pixel_x = 7
	},
/obj/item/kitchen/spoon/iron{
	pixel_x = -3;
	pixel_y = -1
	},
/obj/item/kitchen/spoon/iron{
	pixel_x = 3
	},
/turf/open/floor/rogue/naturalstone,
/area/rogue)
"Eq" = (
/obj/item/natural/stone{
	pixel_x = 9;
	pixel_y = 5
	},
/obj/item/natural/stone{
	pixel_x = -6;
	pixel_y = -7
	},
/turf/open/floor/rogue/naturalstone,
/area/rogue)
"EE" = (
/obj/item/natural/dirtclod,
/turf/open/floor/rogue/dirt,
/area/rogue)
"Fy" = (
/obj/structure/kneestingers{
	icon_state = "glowshroom_A1"
	},
/turf/open/floor/rogue/dirt,
/area/rogue)
"GC" = (
/turf/open/water/swamp/deep,
/area/rogue)
"IB" = (
/obj/item/natural/rock/random,
/turf/open/floor/rogue/naturalstone,
/area/rogue)
"IP" = (
/obj/machinery/light/rogue/firebowl/standing/blue,
/turf/open/floor/rogue/dirt/road,
/area/rogue)
"Lx" = (
/obj/structure/closet/dirthole/grave,
/turf/open/floor/rogue/dirt/road,
/area/rogue)
"Ly" = (
/obj/structure/closet/dirthole/grave,
/obj/structure/closet/burial_shroud,
/mob/living/carbon/human/species/skeleton/no_equipment,
/turf/open/floor/rogue/dirt,
/area/rogue)
"MX" = (
/obj/structure/fluff/grindwheel,
/turf/open/floor/rogue/naturalstone,
/area/rogue)
"Nq" = (
/turf/open/water/swamp,
/area/rogue)
"Nr" = (
/obj/machinery/light/rogue/torchholder/r,
/turf/open/floor/rogue/naturalstone,
/area/rogue)
"NC" = (
/turf/open/floor/rogue/grass/yel,
/area/rogue)
"Oh" = (
/obj/structure/stairs/stone{
	dir = 1
	},
/turf/open/floor/rogue/dirt,
/area/rogue)
"OL" = (
/obj/structure/kneestingers{
	icon_state = "glowshroom_A2"
	},
/turf/open/floor/rogue/dirt,
/area/rogue)
"OW" = (
/obj/structure/closet/dirthole/closed,
/mob/living/carbon/human/species/skeleton/npc/ambush,
/turf/open/floor/rogue/dirt/road,
/area/rogue)
"Rk" = (
/obj/structure/closet/dirthole/closed,
/obj/item/rogueweapon/shield/wood,
/turf/open/floor/rogue/dirt/road,
/area/rogue)
"Sk" = (
/obj/structure/stairs/stone,
/turf/open/floor/rogue/herringbone,
/area/rogue)
"SP" = (
/obj/structure/kneestingers{
	icon_state = "glowshroom2"
	},
/turf/open/floor/rogue/dirt,
/area/rogue)
"Vc" = (
/obj/structure/flora/roguegrass/bush,
/turf/open/floor/rogue/grass/yel,
/area/rogue)
"Wk" = (
/mob/living/carbon/human/species/skeleton/npc/peasant,
/obj/item/rogueweapon/shovel,
/turf/open/floor/rogue/dirt/road,
/area/rogue)
"WI" = (
/obj/structure/kneestingers{
	icon_state = "glowshroom3"
	},
/turf/open/water/swamp,
/area/rogue)
"Xc" = (
/obj/item/grown/log/tree/small,
/turf/open/floor/rogue/naturalstone,
/area/rogue)
"XK" = (
/turf/open/floor/rogue/dirt/road,
/area/rogue)
"XO" = (
/obj/structure/flora/rogueshroom,
/turf/open/water/swamp,
/area/rogue)
"XV" = (
/obj/item/natural/dirtclod,
/turf/open/floor/rogue/dirt/road,
/area/rogue)
"XW" = (
/turf/closed/wall/mineral/rogue/decostone,
/area/rogue)
"Yg" = (
/obj/structure/closet/dirthole/closed,
/turf/open/floor/rogue/dirt/road,
/area/rogue)

(1,1,1) = {"
iR
iR
iR
iR
iR
iR
iR
iR
iR
iR
iR
iR
XK
XK
XK
XK
iR
iR
iR
iR
iR
iR
iR
iR
iR
iR
iR
iR
iR
iR
"}
(2,1,1) = {"
iR
iR
iR
iR
iR
iR
iR
iR
iR
iR
in
in
XK
XK
XK
XK
XK
XK
aH
iR
iR
iR
iR
iR
iR
iR
iR
iR
iR
iR
"}
(3,1,1) = {"
iR
iR
iR
iR
iR
iR
iR
iR
iR
iR
iR
Nq
Nq
in
XK
XK
in
aH
iR
iR
iR
iR
CI
Nq
iR
iR
iR
iR
iR
iR
"}
(4,1,1) = {"
iR
iR
iR
iR
iR
iR
iR
iR
iR
iR
iR
iR
iR
Nq
in
XK
XK
Nq
Nq
in
iR
in
aH
XK
iR
iR
iR
iR
iR
iR
"}
(5,1,1) = {"
iR
iR
iR
iR
iR
iR
iR
iR
iR
iR
iR
iR
iR
in
in
in
Nq
Nq
XO
Nq
Nq
aH
aH
XW
iR
iR
iR
iR
iR
iR
"}
(6,1,1) = {"
iR
iR
iR
iR
iR
iR
iR
iR
iR
iR
iR
iR
iR
iR
Nq
Nq
vl
XO
Nq
Nq
aH
aH
aH
aH
in
iR
iR
iR
iR
iR
"}
(7,1,1) = {"
iR
iR
iR
iR
iR
iR
iR
iR
iR
iR
iR
iR
iR
iR
iR
XO
Nq
Nq
Nq
in
eL
tc
aH
aH
aH
Bh
iR
iR
iR
iR
"}
(8,1,1) = {"
iR
iR
iR
iR
iR
iR
iR
iR
iR
iR
iR
iR
iR
iR
iR
iR
Nq
vl
in
XK
eL
rp
aH
XW
aH
iR
iR
iR
iR
iR
"}
(9,1,1) = {"
iR
iR
iR
iR
iR
iR
iR
iR
iR
iR
iR
iR
iR
iR
iR
iR
iR
Nq
aH
XK
XK
aH
aH
iR
iR
iR
iR
iR
iR
iR
"}
(10,1,1) = {"
iR
iR
iR
iR
iR
iR
iR
iR
iR
iR
iR
in
BF
dE
iR
iR
iR
iR
iR
iR
iR
aH
in
iR
iR
iR
iR
iR
iR
iR
"}
(11,1,1) = {"
iR
iR
iR
iR
iR
iR
iR
iR
in
CZ
az
in
XK
XK
Lx
iR
iR
iR
iR
iR
iR
iR
Nq
XW
iR
iR
iR
iR
iR
iR
"}
(12,1,1) = {"
iR
iR
iR
iR
CZ
EE
yG
in
qA
in
in
qA
IP
Lx
Wk
Lx
iR
iR
iR
iR
iR
iR
iR
iR
iR
iR
iR
AG
XK
XK
"}
(13,1,1) = {"
XK
XK
CZ
wu
in
in
XV
XK
XK
XK
XK
XK
XK
XK
XK
XK
qA
XK
CZ
iL
hY
AG
iR
iR
Rk
Yg
XK
XK
XK
XK
"}
(14,1,1) = {"
XK
in
qA
qA
in
XK
XK
fy
XK
XK
iR
in
in
XK
in
XK
XK
XK
XK
in
XK
XK
XK
XW
XK
in
qA
iR
Lx
XK
"}
(15,1,1) = {"
in
in
XK
XK
XK
XK
Lx
XK
XK
fy
XK
XK
EE
qA
in
CZ
iR
wu
XK
XK
XV
in
XK
XK
in
in
XK
in
XK
XK
"}
(16,1,1) = {"
XK
XK
XK
XV
XK
fy
XK
qA
BF
in
XK
XK
XK
in
wu
iR
lA
XK
XK
XK
XK
in
qA
Lx
in
XK
XK
XK
in
XK
"}
(17,1,1) = {"
XK
XK
XK
XK
XK
XK
in
AG
iR
iR
EE
XK
fy
XK
in
in
in
XK
qA
in
in
XK
XK
XW
Lx
XK
qA
in
in
in
"}
(18,1,1) = {"
XK
XK
XK
fy
XK
in
Dz
oM
iR
iR
xy
XV
XK
iR
iR
OW
XK
XK
XK
XK
XK
cc
XK
XK
XK
XK
Yg
Yg
iR
iR
"}
(19,1,1) = {"
iR
XK
XK
XK
XK
in
in
xP
iR
CZ
XK
lA
iR
iR
iR
iR
Yg
in
EE
fy
XK
XK
XK
Lx
DA
iR
iR
iR
iR
iR
"}
(20,1,1) = {"
iR
XK
XK
XK
XV
XK
XK
XK
XK
XK
XK
CZ
iR
iR
iR
iR
qA
in
XK
xP
rr
qA
CZ
XW
iR
iR
iR
iR
iR
iR
"}
(21,1,1) = {"
iR
iR
XK
fy
XK
Lx
AG
XV
XK
in
qA
mj
iR
iR
iR
iR
rU
iR
iR
iR
iR
iR
iR
iR
iR
iR
iR
Nq
iR
iR
"}
(22,1,1) = {"
iR
iR
in
XK
XK
XK
XK
XK
in
in
ew
iR
iR
iR
iR
iR
iR
iR
iR
iR
Nq
XK
iR
iR
XK
in
Nq
wj
Nq
iR
"}
(23,1,1) = {"
iR
iR
lA
qA
qA
IP
XV
gp
qA
sF
iR
iR
iR
iR
iR
iR
iR
iR
iR
wj
Nq
XK
iR
XW
XK
tc
Oh
in
iR
iR
"}
(24,1,1) = {"
iR
iR
iR
lA
in
in
in
in
CZ
iR
iR
iR
mu
iR
iR
iR
iR
iR
si
Nq
XK
XK
XK
iR
XK
rp
Oh
in
vl
iR
"}
(25,1,1) = {"
iR
iR
iR
iR
lA
xP
iv
Ly
iR
iR
iR
aH
Nq
aH
iR
iR
iR
XK
XK
XK
XK
XK
XK
XK
XK
XK
in
in
Nq
iR
"}
(26,1,1) = {"
iR
iR
iR
iR
iR
iR
iR
iR
iR
iR
Nq
vl
Nq
Nq
Nq
XK
NC
NC
XK
XK
XK
XK
XK
XK
XK
in
Nq
iR
iR
iR
"}
(27,1,1) = {"
iR
iR
iR
iR
iR
iR
iR
iR
iR
iR
XK
Nq
WI
Nq
XK
NC
NC
NC
mJ
NC
XK
XK
iR
iR
Nq
Nq
Nq
iR
iR
iR
"}
(28,1,1) = {"
iR
iR
iR
iR
iR
iR
iR
iR
iR
iR
XK
XK
XK
XK
XK
NC
hQ
iR
iR
NC
mJ
iR
iR
iR
Nq
vl
iR
iR
iR
iR
"}
(29,1,1) = {"
iR
iR
iR
iR
iR
iR
iR
iR
iR
iR
iR
XK
XK
NC
NC
NC
hQ
iR
iR
Vc
hQ
NC
XK
Nq
Nq
iR
iR
iR
iR
iR
"}
(30,1,1) = {"
iR
iR
iR
iR
iR
iR
iR
iR
iR
iR
iR
iR
iR
NC
NC
NC
iR
iR
iR
iR
iR
iR
iR
iR
iR
iR
iR
iR
iR
iR
"}

(1,1,2) = {"
iR
iR
iR
iR
iR
iR
iR
iR
iR
iR
iR
iR
iR
aH
aH
aH
iR
iR
iR
iR
iR
iR
iR
iR
iR
iR
iR
iR
iR
iR
"}
(2,1,2) = {"
iR
iR
iR
iR
iR
iR
iR
iR
iR
iR
iR
iR
aH
aH
aH
aH
aH
aX
aX
in
Bh
Bh
Nq
Nq
Nq
GC
GC
GC
iR
iR
"}
(3,1,2) = {"
iR
iR
iR
iR
iR
iR
iR
iR
iR
iR
iR
iR
iR
aH
aH
aH
aX
aX
in
in
XK
OL
Fy
CI
iR
iR
GC
GC
GC
iR
"}
(4,1,2) = {"
iR
iR
iR
iR
iR
iR
iR
iR
iR
iR
iR
xc
aH
aH
aH
aH
aX
aX
aX
aX
in
in
in
SP
XK
iR
iR
GC
Cj
iR
"}
(5,1,2) = {"
iR
iR
iR
iR
iR
iR
iR
iR
iR
iR
iR
iR
aH
Nr
aH
aX
aX
aX
aX
aX
aX
aX
XK
XK
in
in
iR
iR
iR
iR
"}
(6,1,2) = {"
iR
iR
iR
iR
iR
iR
iR
iR
iR
iR
iR
vd
aH
iR
aH
aX
aX
aX
aX
aX
aX
aX
aH
XK
in
XK
in
iR
iR
iR
"}
(7,1,2) = {"
iR
iR
iR
iR
iR
iR
iR
iR
iR
iR
iR
iR
aH
aH
aH
iR
iR
aX
aX
aX
aX
Sk
pr
pr
pr
in
in
Nq
iR
iR
"}
(8,1,2) = {"
iR
iR
iR
iR
iR
iR
iR
iR
iR
iR
iR
iR
iR
iR
aH
iR
iR
aX
aX
aX
aX
Sk
pr
pr
pr
in
aH
iR
iR
iR
"}
(9,1,2) = {"
iR
iR
iR
iR
iR
iR
iR
iR
iR
iR
iR
iR
iR
iR
aH
iR
iR
iR
aX
aX
iR
iR
iR
pr
pr
aH
in
aH
iR
iR
"}
(10,1,2) = {"
iR
iR
iR
iR
iR
iR
iR
iR
iR
iR
iR
aX
aX
aX
aH
iR
iR
iR
iR
iR
iR
iR
iR
pr
pr
aH
iR
iR
iR
iR
"}
(11,1,2) = {"
iR
iR
iR
iR
iR
iR
iR
iR
aX
aX
aX
aX
aX
aX
aH
iR
iR
iR
iR
iR
iR
iR
iR
pr
pr
aH
aH
iR
iR
iR
"}
(12,1,2) = {"
aH
iR
iR
iR
aH
mu
aH
iR
aX
aX
aX
aX
aX
aX
aH
aH
iR
iR
iR
iR
iR
iR
pr
pr
pr
aH
iR
iR
iR
iR
"}
(13,1,2) = {"
aH
aH
aH
aH
aH
aH
aH
aH
aH
aX
aX
aX
aX
aX
aX
aH
iR
iR
aX
aX
aX
aX
pr
pr
pr
aX
iR
iR
iR
iR
"}
(14,1,2) = {"
aH
aH
aH
aH
aH
aH
aH
aH
aH
aX
aH
aH
aX
aX
aH
aH
iR
aX
aX
aX
aX
aX
pr
pr
pr
iR
iR
iR
iR
aH
"}
(15,1,2) = {"
aH
aH
vd
aH
aH
aH
iR
iR
aX
aX
aX
Xc
aX
aX
aX
iR
iR
aX
aX
aX
aX
aX
pr
pr
pr
aX
iR
iR
aX
aH
"}
(16,1,2) = {"
aH
aH
aH
iR
iR
iR
iR
iR
aX
aX
aX
iR
iR
aX
iR
iR
aX
aX
aX
aX
aX
aX
pr
pr
pr
aX
aX
aX
aX
aH
"}
(17,1,2) = {"
aH
aH
aH
iR
iR
iR
aH
aH
aH
aH
aX
iR
iR
iR
iR
iR
aX
aX
aX
aX
aX
aX
pr
pr
pr
aX
aX
aX
aH
aH
"}
(18,1,2) = {"
iR
iR
aH
aH
aH
aH
aH
aH
aH
ah
iR
iR
iR
iR
iR
iR
iR
aX
aX
aX
aX
aX
pr
pr
pr
aX
aX
aH
aH
iR
"}
(19,1,2) = {"
iR
iR
iR
iR
iR
aH
aH
aH
aH
iR
iR
iR
iR
iR
iR
iR
iR
iR
iR
aX
aX
aX
pr
pr
pr
iR
iR
iR
iR
iR
"}
(20,1,2) = {"
iR
iR
iR
iR
iR
aH
aH
IB
iR
iR
iR
iR
aG
iR
gT
aH
iR
iR
iR
iR
iR
iR
pr
pr
pr
iR
iR
iR
iR
iR
"}
(21,1,2) = {"
iR
iR
iR
aH
aH
aH
xc
iR
iR
iR
aH
dr
aH
iR
iR
AQ
iR
iR
iR
iR
iR
iR
pr
pr
iR
iR
iR
iR
iR
iR
"}
(22,1,2) = {"
iR
aH
aH
aH
iR
iR
iR
iR
iR
iR
aH
iR
aH
IB
iR
aH
iR
iR
iR
iR
aX
aX
pr
pr
iR
iR
iR
iR
iR
iR
"}
(23,1,2) = {"
iR
aH
aH
iR
iR
iR
IB
iR
iR
iR
aH
iR
aH
iR
iR
Eq
aH
iR
iR
aX
aX
aX
pr
pr
pr
oB
aX
iR
iR
iR
"}
(24,1,2) = {"
iR
aH
iR
iR
iR
iR
aH
iR
eK
aH
aG
iR
mN
aH
iR
iR
aH
iR
iR
aX
aX
aX
pr
pr
pr
oB
aX
aX
iR
iR
"}
(25,1,2) = {"
iR
aH
aH
aH
aH
aG
aH
iR
aH
iR
iR
iR
iR
aG
iR
iR
aH
iR
iR
iR
aX
aX
aX
aX
aX
aX
aX
aX
iR
iR
"}
(26,1,2) = {"
iR
aH
iR
iR
iR
aH
iR
iR
aH
aH
aH
aH
aH
aH
aH
iR
aH
iR
iR
aX
aX
aX
aX
aX
aX
aX
aX
iR
iR
iR
"}
(27,1,2) = {"
iR
aH
iR
iR
iR
aH
tW
aH
zU
AQ
iR
iR
aH
aH
aH
aH
aH
iR
iR
iR
aX
aX
aH
aH
aX
iR
iR
iR
iR
iR
"}
(28,1,2) = {"
iR
aH
aH
aH
iR
aH
iR
iR
iR
iR
iR
iR
iR
iR
iR
aH
aH
iR
iR
iR
aX
Ei
aH
DH
iR
iR
iR
iR
iR
iR
"}
(29,1,2) = {"
iR
iR
iR
aG
aH
aH
iR
iR
iR
iR
iR
iR
iR
iR
iR
aH
aH
iR
iR
iR
iR
MX
bd
iR
iR
iR
iR
iR
iR
iR
"}
(30,1,2) = {"
iR
iR
iR
iR
iR
iR
iR
iR
iR
iR
iR
iR
iR
iR
aH
aH
aH
iR
iR
iR
iR
iR
iR
iR
iR
iR
iR
iR
iR
iR
"}
