//MAP CONVERTED BY dmm2tgm.py THIS HEADER COMMENT PREVENTS RECONVERSION, DO NOT REMOVE
"a" = (
/turf/open/water/river{
	dir = 1
	},
/area/rogue)
"c" = (
/turf/open/floor/rogue/blocks,
/area/rogue)
"d" = (
/turf/closed/wall/mineral/rogue/stone,
/area/rogue)
"n" = (
/turf/open/water/river{
	dir = 8
	},
/area/rogue)
"w" = (
/turf/open/water/river{
	dir = 4
	},
/area/rogue)
"y" = (
/turf/open/floor/rogue/naturalstone,
/area/rogue)
"F" = (
/turf/open/water/cleanshallow,
/area/rogue)
"H" = (
/turf/closed/mineral/rogue/bedrock,
/area/rogue)
"M" = (
/turf/open/water/river,
/area/rogue)

(1,1,1) = {"
H
H
H
H
H
H
H
H
H
H
H
H
y
y
y
y
H
H
H
H
H
H
H
H
H
H
H
H
H
H
"}
(2,1,1) = {"
H
H
H
H
H
H
H
H
H
H
H
H
H
y
y
H
H
H
H
H
H
H
H
H
H
H
H
H
H
H
"}
(3,1,1) = {"
H
H
H
H
H
H
H
H
H
H
H
H
H
H
y
y
H
H
H
M
M
w
H
H
H
H
H
H
H
H
"}
(4,1,1) = {"
H
H
H
H
H
H
H
H
H
H
H
H
H
y
y
H
H
H
H
H
M
M
w
H
H
H
H
H
H
H
"}
(5,1,1) = {"
H
H
H
H
H
H
H
H
H
H
H
H
y
y
y
H
H
H
H
H
H
M
M
w
H
H
H
H
H
H
"}
(6,1,1) = {"
H
H
H
H
H
H
H
H
H
H
H
y
y
y
H
H
H
H
H
H
H
H
M
M
w
H
H
H
H
H
"}
(7,1,1) = {"
H
H
H
H
H
H
H
H
y
y
y
y
y
H
H
H
H
H
H
H
H
H
M
w
w
H
H
H
H
H
"}
(8,1,1) = {"
H
H
H
H
H
H
y
y
y
y
y
y
H
H
H
H
H
H
H
H
H
H
H
M
w
a
H
H
H
H
"}
(9,1,1) = {"
H
H
H
H
y
y
H
H
y
y
H
H
H
H
H
H
H
H
H
H
H
H
H
M
w
a
H
H
H
H
"}
(10,1,1) = {"
H
H
H
H
H
H
H
H
H
H
H
H
H
H
H
H
H
H
H
H
H
H
H
M
w
a
H
H
H
H
"}
(11,1,1) = {"
H
H
H
H
H
H
H
H
H
H
H
H
H
H
H
H
H
H
H
H
H
H
H
M
w
a
H
H
H
H
"}
(12,1,1) = {"
H
H
H
H
H
H
H
H
H
H
H
H
H
H
H
H
H
H
H
H
H
H
H
M
w
a
H
H
y
H
"}
(13,1,1) = {"
H
H
H
H
H
H
H
H
H
H
H
H
H
H
H
H
H
H
H
H
H
H
H
M
w
a
H
H
y
y
"}
(14,1,1) = {"
H
H
H
H
H
H
H
H
H
H
H
H
H
H
H
H
H
H
H
H
H
H
H
M
w
a
H
y
y
y
"}
(15,1,1) = {"
H
H
H
H
H
H
H
H
H
H
H
H
H
H
H
H
H
H
H
H
H
H
H
M
w
a
H
y
y
y
"}
(16,1,1) = {"
H
H
H
H
H
H
H
H
H
H
H
H
H
H
H
H
H
H
H
H
H
H
H
M
w
a
H
H
y
y
"}
(17,1,1) = {"
H
y
y
y
y
y
y
y
H
H
H
H
H
H
H
H
H
H
H
H
H
H
w
w
w
a
H
H
y
y
"}
(18,1,1) = {"
H
y
y
y
y
y
y
y
H
H
H
H
H
H
H
H
H
H
H
H
H
H
w
w
w
y
H
H
H
H
"}
(19,1,1) = {"
H
y
y
y
y
y
y
y
H
H
H
H
H
H
H
H
H
H
H
H
H
w
w
w
a
y
H
H
H
H
"}
(20,1,1) = {"
H
y
y
y
y
y
y
y
H
H
H
H
H
H
H
H
H
H
H
H
H
w
w
w
a
y
H
H
H
H
"}
(21,1,1) = {"
H
y
y
y
y
y
y
y
y
H
H
H
H
H
H
H
H
H
H
H
w
w
w
w
a
H
H
H
H
H
"}
(22,1,1) = {"
H
y
y
y
F
F
F
F
y
H
H
H
H
H
H
H
H
H
H
w
w
a
a
a
H
H
H
H
H
H
"}
(23,1,1) = {"
H
y
y
F
F
F
F
F
y
y
y
y
H
H
w
w
w
w
w
a
a
a
a
H
H
H
H
H
H
H
"}
(24,1,1) = {"
H
y
F
F
F
F
F
F
F
y
y
w
w
w
a
M
a
a
a
a
n
H
H
H
H
H
H
H
H
H
"}
(25,1,1) = {"
H
y
F
F
F
F
F
F
F
a
a
a
a
a
a
a
a
a
n
n
H
H
H
H
H
H
H
H
H
H
"}
(26,1,1) = {"
H
y
F
F
F
F
F
F
F
a
a
a
a
n
n
n
n
n
y
y
H
H
H
H
H
H
H
H
H
H
"}
(27,1,1) = {"
H
y
F
F
F
F
F
F
F
F
y
y
y
y
y
y
y
y
y
y
y
H
H
H
H
H
H
H
H
H
"}
(28,1,1) = {"
H
y
y
F
F
F
F
F
F
y
y
y
y
y
y
y
y
y
y
y
y
y
y
y
H
H
H
H
H
H
"}
(29,1,1) = {"
H
y
y
y
y
y
y
y
y
y
y
y
y
y
y
y
y
y
y
y
y
y
y
y
y
H
H
H
H
H
"}
(30,1,1) = {"
H
H
H
H
H
H
H
H
H
H
H
H
H
H
H
H
H
H
H
H
H
H
H
H
H
H
H
H
H
H
"}

(1,1,2) = {"
d
d
d
d
d
d
d
d
d
d
d
d
d
d
d
d
d
d
d
d
d
d
d
d
d
d
d
d
d
d
"}
(2,1,2) = {"
d
c
c
c
c
c
c
c
c
c
c
c
c
c
c
c
c
c
c
c
c
c
c
c
c
c
c
c
c
d
"}
(3,1,2) = {"
d
c
c
c
c
c
c
c
c
c
c
c
c
c
c
c
c
c
c
c
c
c
c
c
c
c
c
c
c
d
"}
(4,1,2) = {"
d
c
c
c
c
c
c
c
c
c
c
c
c
c
c
c
c
c
c
c
c
c
c
c
c
c
c
c
c
d
"}
(5,1,2) = {"
d
c
c
c
c
c
c
c
c
c
c
c
c
c
c
c
c
c
c
c
c
c
c
c
c
c
c
c
c
d
"}
(6,1,2) = {"
d
c
c
c
c
c
c
c
c
c
c
c
c
c
c
c
c
c
c
c
c
c
c
c
c
c
c
c
c
d
"}
(7,1,2) = {"
d
c
c
c
c
c
c
c
c
c
c
c
c
c
c
c
c
c
c
c
c
c
c
c
c
c
c
c
c
d
"}
(8,1,2) = {"
d
c
c
c
c
c
c
c
c
c
c
c
c
c
c
c
c
c
c
c
c
c
c
c
c
c
c
c
c
d
"}
(9,1,2) = {"
d
c
c
c
c
c
c
c
c
c
c
c
c
c
c
c
c
c
c
c
c
c
c
c
c
c
c
c
c
d
"}
(10,1,2) = {"
d
c
c
c
c
c
c
c
c
c
c
c
c
c
c
c
c
c
c
c
c
c
c
c
c
c
c
c
c
d
"}
(11,1,2) = {"
d
c
c
c
c
c
c
c
c
c
c
c
c
c
c
c
c
c
c
c
c
c
c
c
c
c
c
c
c
d
"}
(12,1,2) = {"
d
c
c
c
c
c
c
c
c
c
c
c
c
c
c
c
c
c
c
c
c
c
c
c
c
c
c
c
c
d
"}
(13,1,2) = {"
d
c
c
c
c
c
c
c
c
c
c
c
c
c
c
c
c
c
c
c
c
c
c
c
c
c
c
c
c
d
"}
(14,1,2) = {"
d
c
c
c
c
c
c
c
c
c
c
c
c
c
c
c
c
c
c
c
c
c
c
c
c
c
c
c
c
d
"}
(15,1,2) = {"
d
c
c
c
c
c
c
c
c
c
c
c
c
c
c
c
c
c
c
c
c
c
c
c
c
c
c
c
c
d
"}
(16,1,2) = {"
d
c
c
c
c
c
c
c
c
c
c
c
c
c
c
c
c
c
c
c
c
c
c
c
c
c
c
c
c
d
"}
(17,1,2) = {"
d
c
c
c
c
c
c
c
c
c
c
c
c
c
c
c
c
c
c
c
c
c
c
c
c
c
c
c
c
d
"}
(18,1,2) = {"
d
c
c
c
c
c
c
c
c
c
c
c
c
c
c
c
c
c
c
c
c
c
c
c
c
c
c
c
c
d
"}
(19,1,2) = {"
d
c
c
c
c
c
c
c
c
c
c
c
c
c
c
c
c
c
c
c
c
c
c
c
c
c
c
c
c
d
"}
(20,1,2) = {"
d
c
c
c
c
c
c
c
c
c
c
c
c
c
c
c
c
c
c
c
c
c
c
c
c
c
c
c
c
d
"}
(21,1,2) = {"
d
c
c
c
c
c
c
c
c
c
c
c
c
c
c
c
c
c
c
c
c
c
c
c
c
c
c
c
c
d
"}
(22,1,2) = {"
d
c
c
c
c
c
c
c
c
c
c
c
c
c
c
c
c
c
c
c
c
c
c
c
c
c
c
c
c
d
"}
(23,1,2) = {"
d
c
c
c
c
c
c
c
c
c
c
c
c
c
c
c
c
c
c
c
c
c
c
c
c
c
c
c
c
d
"}
(24,1,2) = {"
d
c
c
c
c
c
c
c
c
c
c
c
c
c
c
c
c
c
c
c
c
c
c
c
c
c
c
c
c
d
"}
(25,1,2) = {"
d
c
c
c
c
c
c
c
c
c
c
c
c
c
c
c
c
c
c
c
c
c
c
c
c
c
c
c
c
d
"}
(26,1,2) = {"
d
c
c
c
c
c
c
c
c
c
c
c
c
c
c
c
c
c
c
c
c
c
c
c
c
c
c
c
c
d
"}
(27,1,2) = {"
d
c
c
c
c
c
c
c
c
c
c
c
c
c
c
c
c
c
c
c
c
c
c
c
c
c
c
c
c
d
"}
(28,1,2) = {"
d
c
c
c
c
c
c
c
c
c
c
c
c
c
c
c
c
c
c
c
c
c
c
c
c
c
c
c
c
d
"}
(29,1,2) = {"
d
c
c
c
c
c
c
c
c
c
c
c
c
c
c
c
c
c
c
c
c
c
c
c
c
c
c
c
c
d
"}
(30,1,2) = {"
d
d
d
d
d
d
d
d
d
d
d
d
d
d
d
d
d
d
d
d
d
d
d
d
d
d
d
d
d
d
"}
